год;м;ж;всего;1-е место;м-призовые;ж-призовые
2020;5;1;6;0;0;0
2016;5;2;7;1;1;0
2012;4;4;8;1;1;0
2008;2;0;2;0;0;0
2004;1;0;1;0;0;0
2000;4;2;6;0;0;0
1996;3;3;6;0;2;0
1992;2;4;6;0;0;0
1988;2;2;4;0;0;0
1924;5;5;10;0;0;5
1920;4;4;8;4;3;7
1912;9;3;12;3;3;6
1908;14;8;22;8;15;5
1900;5;1;6;6;10;4
1896;2;0;2;2;3;0
